NO    ./textures/mario.png      

SO ./textures/rojo.png 
EA      ./textures/Fra.png

       WE        ./textures/texture_10.png      


F 89 ,      54 ,      30     

C    +120 ,     +6,     245  


111111111111
1S0001 100011
111101111111
111100001001      
111111111111

