   NO    ./textures/mario.png       
SO ./textures/rojo.png
    WE ./textures/texture_10.png      
EA      ./textures/Fra.png


F     89,      100,                1

C     85,      70,   56

111111111111
1S0000000011
111100001111
111100001001      
111111111111


