NO ./maps/mario.png
SO ./maps/mario.png
WE ./maps/mario.png
EA ./maps/mario.png
F 132,182,97
C 90,218,238

111111111111
1S0000000011
111100001111
111100001001
111111111111








