NO    ./textures/mario.png      

SO ./textures/mario_wall.png 
EA      ./textures/Fra.png

       WE        ./textures/texture_10.png      


F  58,      164 ,      91     

C    120 ,     185,     245  


111111111111
1S0001 100011
111101111111
111100001001      
111111111111

