EA ./textures/mario_world/mario_wall.png
NO ./textures/tests/Fra.png 
SO ./textures/mario_world/mario_wall.png
WE ./textures/tests/Fra.png



C 255 , 70,   1
F 89, 250, 100 

        1111111111
       1E00001
        1111111111
        11111111111
        10000010001     11
        11111111111      1
              1111                     1
              1001
              1111
