NO ./textures/old_game/scarry_wall.png
SO ./textures/old_game/scarry_wall.png
WE ./textures/old_game/scarry_wall.png
EA ./textures/old_game/scarry_wall.png

F 69, 61, 28
C 28, 44, 69

11111111111111111111111111111111111111
1E00000000000000000000000000000000001
1000000000000000000000000000000000001
1011000001110000000000000000000000001
1001000000000000000000000000000000001
111100011011000001110000100000011111111111111111111111111111111111111
100000000011000001110110101111111
11110000001111011100000010001
11110111111111011101010010001
11000000110101011100000010001
10000000000000001100000010001
10000000000000001101010010001
11000001110101011111011110111
11110111 1110101 101111010001
11111111 1111111 111111111111 